data,stato,codice_regione,denominazione_regione,lat,long,ricoverati_con_sintomi,terapia_intensiva,totale_ospedalizzati,isolamento_domiciliare,totale_positivi,variazione_totale_positivi,nuovi_positivi,dimessi_guariti,deceduti,casi_da_sospetto_diagnostico,casi_da_screening,totale_casi,tamponi,casi_testati,note,ingressi_terapia_intensiva,note_test,note_casi,totale_positivi_test_molecolare,totale_positivi_test_antigenico_rapido,tamponi_test_molecolare,tamponi_test_antigenico_rapido,codice_nuts_1,codice_nuts_2
2023-12-06T17:00:00,ITA,13,Abruzzo,42.35122196,13.39843823,226,5,231,6918,7149,421,558,667424,4037,,,678610,7633224,1386909,"Il dato ''incremento casi confermati'' è composto da  558 , cioè 283  ''nuovi positivi'' e  275 ''reinfezioni''. ",1,,,259583,419027,2640364,4992860,ITF,ITF1
2023-12-06T17:00:00,ITA,17,Basilicata,40.63947052,15.80514834,24,0,24,9353,9377,22,26,191466,1047,,,201890,1364476,409076, Il dato relativo al numero dei “Casi in isolamento domiciliare” ed ai “Guariti” è in corso di revisione.,0,,,71280,130610,703994,660482,ITF,ITF5
2023-12-06T17:00:00,ITA,18,Calabria,38.90597598,16.59440194,81,7,88,2418,2506,-7,109,643487,3586,,,649579,4488369,3506624,,0,,,203895,445684,1953908,2534461,ITF,ITF6
2023-12-06T17:00:00,ITA,15,Campania,40.83956555,14.25084984,135,4,139,27970,28109,59,533,2479576,12057,,,2519742,21537905,5478408,,0,,,958648,1561094,9717771,11820134,ITF,ITF3
2023-12-06T17:00:00,ITA,08,Emilia-Romagna,44.49436681,11.3417208,1421,34,1455,8494,9949,138,683,2167007,19819,,,2196775,19940171,2996855,,5,,,1098159,1098616,10794972,9145199,ITH,ITH5
2023-12-06T17:00:00,ITA,06,Friuli Venezia Giulia,45.6494354,13.76813649,248,8,256,1225,1481,39,193,585814,6330,,,593625,7845629,1274478,,1,,,241627,351998,3883611,3962018,ITH,ITH4
2023-12-06T17:00:00,ITA,12,Lazio,41.89277044,12.48366722,558,21,579,42479,43058,505,1217,2434357,13108,,,2490523,27246175,6238504,,2,,,1041822,1448701,9750218,17495957,ITI,ITI4
2023-12-06T17:00:00,ITA,07,Liguria,44.41149315,8.9326992,299,6,305,0,305,5,243,677228,5998,,,683531,7087447,1540844,,1,,*di cui 58285  reinfezioni a partire dal 3/09/2021 [circ. min sal. n.37911 del 20/08/2021].,288561,394970,2710845,4376602,ITC,ITC3
2023-12-06T17:00:00,ITA,03,Lombardia,45.46679409,9.190347404,650,39,689,16000,16689,722,2027,4233181,46915,,,4296785,46697050,9393857,,7,,,1548501,2748284,17175953,29521097,ITC,ITC4
2023-12-06T17:00:00,ITA,11,Marche,43.61675973,13.5188753,243,4,247,0,247,73,219,726288,4499,,,731034,3786105,2783813,,2,,,223280,507754,2020357,1765748,ITI,ITI3
2023-12-06T17:00:00,ITA,14,Molise,41.55774754,14.65916051,13,0,13,959,972,51,46,102635,775,,,104382,841929,793065,,0,,,30526,73856,551490,290439,ITF,ITF2
2023-12-06T17:00:00,ITA,21,P.A. Bolzano,46.49933453,11.35662422,38,1,39,0,39,-6,31,298313,1647,,,299999,5620881,869816,"31 nuovi positivi di cui 1 test antigenici confermati da test molecolare, 30 casi diagnosticati con test antigenico e 0 nuovi positivi al test PCR. ",0,,"31 nuovi positivi di cui 1 test antigenici confermati da test molecolare, 30 casi diagnosticati con test antigenico e 0 nuovi positivi al test PCR. ",87416,212583,941352,4679529,ITH,ITH1
2023-12-06T17:00:00,ITA,22,P.A. Trento,46.06893511,11.12123097,88,2,90,798,888,-16,88,249397,1669,,,251954,3081063,608988,,0,,,45634,206320,878133,2202930,ITH,ITH2
2023-12-06T17:00:00,ITA,01,Piemonte,45.0732745,7.680687483,598,19,617,50631,51248,330,723,1723173,13897,,,1788318,22296987,4493166,,3,,,519446,1268872,5147758,17149229,ITC,ITC1
2023-12-06T17:00:00,ITA,16,Puglia,41.12559576,16.86736689,148,7,155,6766,6921,307,480,1651025,9914,,,1667860,14426647,3000859,,1,,,514532,1153328,4884185,9542462,ITF,ITF4
2023-12-06T17:00:00,ITA,20,Sardegna,39.21531192,9.110616306,156,0,156,8746,8902,12,18,513092,2975,,,524969,5547144,1766724,,0,,,180339,344630,2246556,3300588,ITG,ITG2
2023-12-06T17:00:00,ITA,19,Sicilia,38.11569725,13.3623567,196,6,202,1858,2060,16,16,1818290,12942,,,1833292,16951304,11287677,,5,,,541985,1291307,5485779,11465525,ITG,ITG1
2023-12-06T17:00:00,ITA,09,Toscana,43.76923077,11.25588885,519,22,541,4044,4585,137,535,1622948,12246,,,1639779,17164600,5454168,,2,,,727506,912273,7127666,10036934,ITI,ITI1
2023-12-06T17:00:00,ITA,10,Umbria,43.10675841,12.38824698,214,6,220,1965,2185,40,212,449983,2518,,,454686,5140728,824659,"Si fa presente che dei 214 ricoveri non in T.I.: - 94 appartengono alle discipline di area medica (COD.24,COD.26,COD.68.COD.94). - 120 ricoveri appartengono ad altre discipline ospedaliere.",0,,,160391,294295,1761654,3379074,ITI,ITI2
2023-12-06T17:00:00,ITA,02,Valle d'Aosta,45.73750286,7.320149366,17,0,17,81,98,12,13,51476,579,,,52153,602325,147966,,0,,,16412,35741,146381,455944,ITC,ITC2
2023-12-06T17:00:00,ITA,05,Veneto,45.43490485,12.33845213,796,28,824,15026,15850,1682,3535,2782823,17184,,,2815857,38868192,5408230,Nei valori riportati per le terapie intensive si è verificato un disallineamento temporale del flusso informativo pertanto per convenzione è stato riportato 10 dimessi da TI  invece del n. 6 effettivi che include anche i negativizzati.,8,,,1134521,1681336,12035323,26832869,ITH,ITH3
