data,stato,codice_regione,denominazione_regione,lat,long,ricoverati_con_sintomi,terapia_intensiva,totale_ospedalizzati,isolamento_domiciliare,totale_positivi,variazione_totale_positivi,nuovi_positivi,dimessi_guariti,deceduti,casi_da_sospetto_diagnostico,casi_da_screening,totale_casi,tamponi,casi_testati,note,ingressi_terapia_intensiva,note_test,note_casi,totale_positivi_test_molecolare,totale_positivi_test_antigenico_rapido,tamponi_test_molecolare,tamponi_test_antigenico_rapido,codice_nuts_1,codice_nuts_2
2024-03-06T17:00:00,ITA,13,Abruzzo,42.35122196,13.39843823,11,0,11,8428,8439,-8,15,676542,4090,,,689071,7698038,1392091,"Il dato ""Incremento casi confermati"" è composto da 15 cioè 0 ""nuovi positivi"" e 15 ""reinfezioni"".",0,,,264168,424903,2649173,5048865,ITF,ITF1
2024-03-06T17:00:00,ITA,17,Basilicata,40.63947052,15.80514834,3,1,4,9874,9878,1,1,191604,1054,,,202536,1374924,410695,Il dato relativo al numero dei “Casi in isolamento domiciliare” ed ai “Guariti” non è reale ed è in corso di revisione.,0,,,71288,131248,704640,670284,ITF,ITF5
2024-03-06T17:00:00,ITA,18,Calabria,38.90597598,16.59440194,8,1,9,3453,3462,-4,3,648111,3674,,,655247,4534873,3547124,,0,,,204349,450898,1962947,2571926,ITF,ITF6
2024-03-06T17:00:00,ITA,15,Campania,40.83956555,14.25084984,76,3,79,10575,10654,-4,5,2525464,12141,,,2548259,21853492,5515054,,0,,,959935,1588324,9750691,12102801,ITF,ITF3
2024-03-06T17:00:00,ITA,08,Emilia-Romagna,44.49436681,11.3417208,122,4,126,168,294,-12,10,2190036,20033,,,2210363,20076612,3003273,"Il dato odierno dei casi per la provincia, risultato negativo rispetto a quello comunicato ieri, è determinato dalla revisione delle posizioni anagrafiche dei casi precedentemente inseriti.",0,,,1100080,1110283,10823049,9253563,ITH,ITH5
2024-03-06T17:00:00,ITA,06,Friuli Venezia Giulia,45.6494354,13.76813649,5,0,5,290,295,3,6,591947,6448,,,598690,7882915,1279347,,0,,,242469,356221,3893432,3989483,ITH,ITH4
2024-03-06T17:00:00,ITA,12,Lazio,41.89277044,12.48366722,240,5,245,60664,60909,17,17,2456868,13262,,,2531039,27543342,6270940,,0,,,1043001,1488038,9760331,17783011,ITI,ITI4
2024-03-06T17:00:00,ITA,07,Liguria,44.41149315,8.9326992,6,0,6,0,6,-1,2,684109,6018,,,690133,7140893,1548873,,0,,*di cui 61021  reinfezioni a partire dal 3/09/2021 [circ. min sal. n.37911 del 20/08/2021].,288790,401343,2714228,4426665,ITC,ITC3
2024-03-06T17:00:00,ITA,03,Lombardia,45.46679409,9.190347404,180,1,181,420,601,-21,27,4290553,47848,,,4339002,47148263,9456277,,0,,,1552958,2786044,17205536,29942727,ITC,ITC4
2024-03-06T17:00:00,ITA,11,Marche,43.61675973,13.5188753,9,0,9,0,9,0,0,732401,4559,,,736969,3803219,2800925,,0,,,223417,513552,2020834,1782385,ITI,ITI3
2024-03-06T17:00:00,ITA,14,Molise,41.55774754,14.65916051,0,0,0,4,4,0,0,104768,798,,,105570,852149,802866,,0,,,31117,74453,555273,296876,ITF,ITF2
2024-03-06T17:00:00,ITA,21,P.A. Bolzano,46.49933453,11.35662422,4,0,4,0,4,0,2,299343,1668,,,301015,5627721,870930,"2 nuovi positivi di cui 1 test antigenici confermati da test molecolare, 0 casi diagnosticati con test antigenico e 1 nuovi positivi al test PCR.",0,,"2 nuovi positivi di cui 1 test antigenici confermati da test molecolare, 0 casi diagnosticati con test antigenico e 1 nuovi positivi al test PCR.",87633,213382,944182,4683539,ITH,ITH1
2024-03-06T17:00:00,ITA,22,P.A. Trento,46.06893511,11.12123097,1,0,1,9,10,-1,0,251740,1681,,,253431,3092973,610085,,0,,,45800,207631,879568,2213405,ITH,ITH2
2024-03-06T17:00:00,ITA,01,Piemonte,45.0732745,7.680687483,54,1,55,54584,54639,-38,5,1735436,13928,,,1804003,22513075,4524833,,0,,,519863,1284140,5151726,17361349,ITC,ITC1
2024-03-06T17:00:00,ITA,16,Puglia,41.12559576,16.86736689,7,0,7,398,405,3,7,1677662,10076,,,1688143,14604966,3029488,,0,,,515225,1172918,4889840,9715126,ITF,ITF4
2024-03-06T17:00:00,ITA,20,Sardegna,39.21531192,9.110616306,23,1,24,9462,9486,-3,2,513996,2977,,,526459,5579632,1767615,,0,,,180340,346119,2247603,3332029,ITG,ITG2
2024-03-06T17:00:00,ITA,19,Sicilia,38.11569725,13.3623567,82,4,86,817,903,-8,1,1820655,13049,,,1834607,16963952,11300088,,1,,,542956,1291651,5496575,11467377,ITG,ITG1
2024-03-06T17:00:00,ITA,09,Toscana,43.76923077,11.25588885,20,1,21,240,261,-8,7,1640732,12487,,,1653480,17307836,5468509,,1,,,732205,921275,7144734,10163102,ITI,ITI1
2024-03-06T17:00:00,ITA,10,Umbria,43.10675841,12.38824698,31,1,32,521,553,0,2,455950,2526,,,459029,5167829,828463,"Si fa presente che dei 31 ricoveri non in T.I.: - 11 appartengono alle discipline di area medica (COD.24, COD.26, COD.68, COD.94) - 20 ricoveri appartengono ad altre discipline ospedaliere.",0,,,160665,298364,1763828,3404001,ITI,ITI2
2024-03-06T17:00:00,ITA,02,Valle d'Aosta,45.73750286,7.320149366,0,0,0,3,3,-1,0,51870,591,,,52464,606141,148563,,0,,,16497,35967,146684,459457,ITC,ITC2
2024-03-06T17:00:00,ITA,05,Veneto,45.43490485,12.33845213,208,8,216,9497,9713,-2,23,2813815,17471,,,2840999,39274655,5440846,"Si segnala un delta negativo registrato per i casi positivi nelle province di Treviso, Vicenza, Rovigo, fuori regione. Dall'analisi effettuata emerge che il delta negativo registrato è un risultato fisiologico dell’elaborazione che registra pochi casi nuovi di positività e che può essere indotto in particolare da un cambio domicilio/residenza o variazioni inviate sugli episodi precedenti.",2,,,1149886,1691113,12161370,27113285,ITH,ITH3
