data,stato,codice_regione,denominazione_regione,lat,long,ricoverati_con_sintomi,terapia_intensiva,totale_ospedalizzati,isolamento_domiciliare,totale_positivi,variazione_totale_positivi,nuovi_positivi,dimessi_guariti,deceduti,casi_da_sospetto_diagnostico,casi_da_screening,totale_casi,tamponi,casi_testati,note,ingressi_terapia_intensiva,note_test,note_casi,totale_positivi_test_molecolare,totale_positivi_test_antigenico_rapido,tamponi_test_molecolare,tamponi_test_antigenico_rapido,codice_nuts_1,codice_nuts_2
2024-02-05T17:00:00,ITA,13,Abruzzo,42.35122196,13.39843823,33,2,35,8861,8896,-2,4,675923,4090,,,688909,7689848,1391067,"Il dato ''incremento casi confermati'' è composto da 4, cioè 0 ''nuovi positivi'' e 4 ''reinfezioni''. ",0,,,264057,424852,2647602,5042246,ITF,ITF1
2024-02-05T17:00:00,ITA,17,Basilicata,40.63947052,15.80514834,12,1,13,9882,9895,0,0,191577,1054,,,202526,1372113,410333,Il dato relativo al numero dei “Casi in isolamento domiciliare” ed ai “Guariti” è in corso di revisione.,0,,,71287,131239,704036,668077,ITF,ITF5
2024-02-05T17:00:00,ITA,18,Calabria,38.90597598,16.59440194,22,4,26,3525,3551,-6,4,647869,3664,,,655084,4524048,3536995,,1,,,204313,450771,1960898,2563150,ITF,ITF6
2024-02-05T17:00:00,ITA,15,Campania,40.83956555,14.25084984,97,4,101,10652,10753,11,12,2524857,12131,,,2547741,21768367,5505128,,0,,,959892,1587849,9742211,12026156,ITF,ITF3
2024-02-05T17:00:00,ITA,08,Emilia-Romagna,44.49436681,11.3417208,319,16,335,573,908,-39,10,2189046,20015,,,2209969,20044699,3001616,"Il dato odierno dei casi per la provincia, risultato negativo rispetto a quello comunicato ieri, è determinato dalla revisione delle posizioni anagrafiche dei casi precedentemente inseriti.",0,,,1099987,1109982,10816355,9228344,ITH,ITH5
2024-02-05T17:00:00,ITA,06,Friuli Venezia Giulia,45.6494354,13.76813649,20,0,20,319,339,0,7,591749,6438,,,598526,7875024,1278160,,0,,,242409,356117,3890597,3984427,ITH,ITH4
2024-02-05T17:00:00,ITA,12,Lazio,41.89277044,12.48366722,259,10,269,59414,59683,12,36,2457226,13252,,,2530161,27483538,6262119,,0,,,1042897,1487264,9757786,17725752,ITI,ITI4
2024-02-05T17:00:00,ITA,07,Liguria,44.41149315,8.9326992,51,3,54,0,54,-3,2,683941,6017,,,690012,7130030,1547066,,0,,*di cui 60971  reinfezioni a partire dal 3/09/2021 [circ. min sal. n.37911 del 20/08/2021].,288775,401237,2713226,4416804,ITC,ITC3
2024-02-05T17:00:00,ITA,03,Lombardia,45.46679409,9.190347404,307,16,323,1969,2292,-149,39,4287401,47761,,,4337454,47044695,9440458,,0,,,1552514,2784940,17198269,29846426,ITC,ITC4
2024-02-05T17:00:00,ITA,11,Marche,43.61675973,13.5188753,24,1,25,0,25,0,3,732296,4554,,,736875,3800560,2798268,,0,,,223415,513460,2020756,1779804,ITI,ITI3
2024-02-05T17:00:00,ITA,14,Molise,41.55774754,14.65916051,4,0,4,179,183,0,0,104585,797,,,105565,850261,800987,,0,,,31114,74451,554607,295654,ITF,ITF2
2024-02-05T17:00:00,ITA,21,P.A. Bolzano,46.49933453,11.35662422,5,0,5,0,5,-2,3,299296,1665,,,300966,5626161,870596,"3 nuovi positivi di cui 1 test antigenici confermati da test molecolare, 0 casi diagnosticati con test antigenico e 2 nuovi positivi al test PCR. ",0,,"3 nuovi positivi di cui 1 test antigenici confermati da test molecolare, 0 casi diagnosticati con test antigenico e 2 nuovi positivi al test PCR. ",87605,213361,943156,4683005,ITH,ITH1
2024-02-05T17:00:00,ITA,22,P.A. Trento,46.06893511,11.12123097,7,0,7,23,30,-5,0,251671,1680,,,253381,3091128,609894,,0,,,45791,207590,879288,2211840,ITH,ITH2
2024-02-05T17:00:00,ITA,01,Piemonte,45.0732745,7.680687483,100,2,102,55208,55310,-9,6,1734367,13925,,,1803602,22459050,4515678,,1,,,519833,1283769,5150754,17308296,ITC,ITC1
2024-02-05T17:00:00,ITA,16,Puglia,41.12559576,16.86736689,41,4,45,3497,3542,-4,8,1674040,10058,,,1687640,14557102,3019909,,0,,,515192,1172448,4888295,9668807,ITF,ITF4
2024-02-05T17:00:00,ITA,20,Sardegna,39.21531192,9.110616306,46,3,49,9485,9534,0,0,513879,2976,,,526389,5571536,1767327,,0,,,180339,346050,2247266,3324270,ITG,ITG2
2024-02-05T17:00:00,ITA,19,Sicilia,38.11569725,13.3623567,129,6,135,988,1123,1,1,1820350,13036,,,1834509,16960250,11296371,,1,,,542909,1291600,5493423,11466827,ITG,ITG1
2024-02-05T17:00:00,ITA,09,Toscana,43.76923077,11.25588885,86,0,86,587,673,-137,10,1639877,12477,,,1653027,17269320,5464032,,0,,,731913,921114,7140533,10128787,ITI,ITI1
2024-02-05T17:00:00,ITA,10,Umbria,43.10675841,12.38824698,50,1,51,560,611,1,2,455819,2524,,,458954,5161415,827508,"Si fa presente che dei 50 ricoveri non in T.I.: - 16 appartengono alle discipline di area medica (COD.24, COD.26, COD.68, COD.94) - 34 ricoveri appartengono ad altre discipline ospedaliere.",0,,,160639,298315,1763161,3398254,ITI,ITI2
2024-02-05T17:00:00,ITA,02,Valle d'Aosta,45.73750286,7.320149366,1,0,1,13,14,0,0,51850,589,,,52453,605028,148365,,0,,,16495,35958,146639,458389,ITC,ITC2
2024-02-05T17:00:00,ITA,05,Veneto,45.43490485,12.33845213,305,12,317,9545,9862,-60,19,2812487,17434,,,2839783,39160192,5430584,,0,,,1148986,1690797,12120391,27039801,ITH,ITH3
