data,stato,codice_regione,denominazione_regione,lat,long,ricoverati_con_sintomi,terapia_intensiva,totale_ospedalizzati,isolamento_domiciliare,totale_positivi,variazione_totale_positivi,nuovi_positivi,dimessi_guariti,deceduti,casi_da_sospetto_diagnostico,casi_da_screening,totale_casi,tamponi,casi_testati,note,ingressi_terapia_intensiva,note_test,note_casi,totale_positivi_test_molecolare,totale_positivi_test_antigenico_rapido,tamponi_test_molecolare,tamponi_test_antigenico_rapido,codice_nuts_1,codice_nuts_2
2024-04-07T17:00:00,ITA,13,Abruzzo,42.35122196,13.39843823,3,0,3,8413,8416,0,0,676601,4092,,,689109,7704677,1393138,"Il dato ""incremento casi confermati"" è composto da 0, cioè 0 nuovi positivi e 0 reinfezioni.",0,,,264190,424919,2650479,5054198,ITF,ITF1
2024-04-07T17:00:00,ITA,17,Basilicata,40.63947052,15.80514834,0,0,0,9874,9874,0,0,191609,1055,,,202538,1376001,411019,Il dato relativo al numero dei “Casi in isolamento domiciliare” ed ai “Guariti” non è reale ed è in corso di revisione.,0,,,71288,131250,704040,671961,ITF,ITF5
2024-04-07T17:00:00,ITA,18,Calabria,38.90597598,16.59440194,0,0,0,3434,3434,0,0,648165,3676,,,655275,4543941,3558723,,0,,,204361,450914,1964527,2579414,ITF,ITF6
2024-04-07T17:00:00,ITA,15,Campania,40.83956555,14.25084984,71,3,74,7026,7100,7,7,2529247,12143,,,2548490,21927740,5533188,,0,,,959952,1588538,9757757,12169983,ITF,ITF3
2024-04-07T17:00:00,ITA,08,Emilia-Romagna,44.49436681,11.3417208,53,5,58,107,165,5,7,2190363,20035,,,2210563,20118008,3004640,"Il dato odierno dei casi per la provincia, risultato negativo rispetto a quello comunicato ieri, è determinato dalla revisione delle posizioni anagrafiche dei casi precedentemente inseriti.",1,,,1100146,1110417,10828467,9289541,ITH,ITH5
2024-04-07T17:00:00,ITA,06,Friuli Venezia Giulia,45.6494354,13.76813649,1,1,2,279,281,-2,0,591995,6452,,,598728,7889760,1280420,,0,,,242487,356241,3895944,3993816,ITH,ITH4
2024-04-07T17:00:00,ITA,12,Lazio,41.89277044,12.48366722,205,4,209,60467,60676,2,4,2457509,13268,,,2531453,27597226,6279430,,0,,,1043031,1488422,9762283,17834943,ITI,ITI4
2024-04-07T17:00:00,ITA,07,Liguria,44.41149315,8.9326992,5,0,5,0,5,-1,0,684139,6018,,,690162,7150224,1550492,,0,,*di cui 61034  reinfezioni a partire dal 3/09/2021 [circ. min sal. n.37911 del 20/08/2021].,288791,401371,2715040,4435184,ITC,ITC3
2024-04-07T17:00:00,ITA,03,Lombardia,45.46679409,9.190347404,28,0,28,231,259,1,12,4291550,47889,,,4339698,47233618,9469692,,0,,,1553134,2786564,17212056,30021562,ITC,ITC4
2024-04-07T17:00:00,ITA,11,Marche,43.61675973,13.5188753,4,0,4,0,4,0,0,732457,4560,,,737021,3805607,2803315,,0,,,223417,513604,2020922,1784685,ITI,ITI3
2024-04-07T17:00:00,ITA,14,Molise,41.55774754,14.65916051,0,0,0,3,3,0,0,104772,798,,,105573,853986,804701,,0,,,31119,74454,555848,298138,ITF,ITF2
2024-04-07T17:00:00,ITA,21,P.A. Bolzano,46.49933453,11.35662422,3,0,3,0,3,0,0,299357,1670,,,301030,5628646,871095,"0 nuovi positivi di cui 0 test antigenici confermati da test molecolare, 0 casi diagnosticati con test antigenico e 0 nuovi positivi al test PCR.",0,,"0 nuovi positivi di cui 0 test antigenici confermati da test molecolare, 0 casi diagnosticati con test antigenico e 0 nuovi positivi al test PCR.",87648,213382,944782,4683864,ITH,ITH1
2024-04-07T17:00:00,ITA,22,P.A. Trento,46.06893511,11.12123097,2,0,2,9,11,0,0,251784,1681,,,253476,3094699,610282,,0,,,45807,207669,879877,2214822,ITH,ITH2
2024-04-07T17:00:00,ITA,01,Piemonte,45.0732745,7.680687483,47,0,47,53954,54001,-8,5,1736251,13928,,,1804180,22565828,4533481,,0,,,519882,1284298,5152362,17413466,ITC,ITC1
2024-04-07T17:00:00,ITA,16,Puglia,41.12559576,16.86736689,2,0,2,87,89,-3,3,1678161,10084,,,1688334,14644380,3037177,,0,,,515236,1173098,4891198,9753182,ITF,ITF4
2024-04-07T17:00:00,ITA,20,Sardegna,39.21531192,9.110616306,23,1,24,9489,9513,0,0,514001,2977,,,526491,5585914,1767681,,0,,,180340,346151,2247693,3338221,ITG,ITG2
2024-04-07T17:00:00,ITA,19,Sicilia,38.11569725,13.3623567,74,4,78,814,892,1,1,1820843,13056,,,1834791,16968272,11304381,,0,,,543130,1291661,5500520,11467752,ITG,ITG1
2024-04-07T17:00:00,ITA,09,Toscana,43.76923077,11.25588885,7,0,7,179,186,1,1,1641004,12501,,,1653691,17342768,5472500,,0,,,732363,921328,7148066,10194702,ITI,ITI1
2024-04-07T17:00:00,ITA,10,Umbria,43.10675841,12.38824698,16,0,16,521,537,1,1,456006,2532,,,459075,5173907,829342,"Si fa presente che dei 16 ricoveri non in T.I.: - 8 appartengono alle discipline di area medica (COD.24, COD.26, COD.68, COD.94) - 8 ricoveri appartengono ad altre discipline ospedaliere.",0,,,160681,298394,1764450,3409457,ITI,ITI2
2024-04-07T17:00:00,ITA,02,Valle d'Aosta,45.73750286,7.320149366,1,0,1,5,6,0,0,51874,591,,,52471,607124,148751,,0,,,16500,35971,146740,460384,ITC,ITC2
2024-04-07T17:00:00,ITA,05,Veneto,45.43490485,12.33845213,176,5,181,9566,9747,2,7,2814215,17487,,,2841449,39376461,5450164,Si segnala che è presente un delta negativo registrato per i casi positivi nei Fuori regione. Dall'analisi effettuata emerge che il delta negativo registrato è un risultato fisiologico dell’elaborazione che registra pochi casi nuovi di positività e che può essere indotto in particolare da un cambio domicilio/residenza o variazioni inviate sugli episodi precedenti.,0,,,1150206,1691243,12198564,27177897,ITH,ITH3
