data,stato,codice_regione,denominazione_regione,lat,long,ricoverati_con_sintomi,terapia_intensiva,totale_ospedalizzati,isolamento_domiciliare,totale_positivi,variazione_totale_positivi,nuovi_positivi,dimessi_guariti,deceduti,casi_da_sospetto_diagnostico,casi_da_screening,totale_casi,tamponi,casi_testati,note,ingressi_terapia_intensiva,note_test,note_casi,totale_positivi_test_molecolare,totale_positivi_test_antigenico_rapido,tamponi_test_molecolare,tamponi_test_antigenico_rapido,codice_nuts_1,codice_nuts_2
2022-12-25T17:00:00,ITA,13,Abruzzo,42.35122196,13.39843823,216,9,225,15403,15628,411,545,613370,3818,,,632816,7260529,1352564,,2,,,240255,392561,2556404,4704125,ITF,ITF1
2022-12-25T17:00:00,ITA,17,Basilicata,40.63947052,15.80514834,46,0,46,7271,7317,53,91,187600,1010,,,195927,1298454,397176,Il dato relativo al numero dei “Casi in isolamento domiciliare” ed ai “Guariti” è in corso di revisione,0,,,70864,125063,697484,600970,ITF,ITF5
2022-12-25T17:00:00,ITA,18,Calabria,38.90597598,16.59440194,151,9,160,6678,6838,83,407,602851,3197,,,612886,4091582,3154419,"La ASP di Cosenza comunica ""Nel setting fuori regione si registra 1 nuovo caso a domicilio""",1,,,199882,413004,1854112,2237470,ITF,ITF6
2022-12-25T17:00:00,ITA,15,Campania,40.83956555,14.25084984,352,20,372,43111,43483,504,1256,2344235,11514,,,2399232,19989197,5328339,,2,,,950075,1449157,9407648,10581549,ITF,ITF3
2022-12-25T17:00:00,ITA,08,Emilia-Romagna,44.49436681,11.3417208,1592,55,1647,24215,25862,-1078,1608,2055636,18870,,,2100368,18936407,2944234,,7,,,1082553,1017815,10483284,8453123,ITH,ITH5
2022-12-25T17:00:00,ITA,06,Friuli Venezia Giulia,45.6494354,13.76813649,223,10,233,5226,5459,-170,331,552039,5824,,,563322,7540250,1241285,Il totale dei casi positivi è stato ridotto di 1 a seguito di un test positivo rimosso dopo revisione del caso (caso relativo alla provincia di PN).,3,,,236517,326805,3764160,3776090,ITH,ITH4
2022-12-25T17:00:00,ITA,12,Lazio,41.89277044,12.48366722,642,25,667,45030,45697,103,2153,2257635,12519,,,2315851,25497648,6042876,,0,,,1031119,1284732,9522299,15975349,ITI,ITI4
2022-12-25T17:00:00,ITA,07,Liguria,44.41149315,8.9326992,443,17,460,5908,6368,-358,467,638813,5744,,,650925,6720115,1490656,,0,,*di cui 47425  reinfezioni a partire dal 3/09/2021 [circ. min sal. n.37911 del 20/08/2021].,280219,370706,2662950,4057165,ITC,ITC3
2022-12-25T17:00:00,ITA,03,Lombardia,45.46679409,9.190347404,1136,32,1168,43075,44243,891,2076,3962339,44584,,,4051166,44218858,9076758,,1,,,1528763,2522403,16899446,27319412,ITC,ITC4
2022-12-25T17:00:00,ITA,11,Marche,43.61675973,13.5188753,183,4,187,6678,6865,-147,575,689349,4275,,,700489,3689383,2687088,,0,,,222338,478151,2014481,1674902,ITI,ITI3
2022-12-25T17:00:00,ITA,14,Molise,41.55774754,14.65916051,10,1,11,6331,6342,37,39,92243,704,,,99289,777260,730306,,0,,,28995,70294,507261,269999,ITF,ITF2
2022-12-25T17:00:00,ITA,21,P.A. Bolzano,46.49933453,11.35662422,33,1,34,618,652,-11,52,287263,1598,,,289513,5527120,859693,"52 nuovi positivi di cui 2 test antigenici confermati da test molecolare, 48 casi diagnosticati con test antigenico e 2 nuovi positivi al test PCR. ",1,,"52 nuovi positivi di cui 2 test antigenici confermati da test molecolare, 48 casi diagnosticati con test antigenico e 2 nuovi positivi al test PCR. ",86697,202816,927120,4600000,ITH,ITH1
2022-12-25T17:00:00,ITA,22,P.A. Trento,46.06893511,11.12123097,46,0,46,893,939,21,117,237484,1632,,,240055,2998797,601002,,0,,,44559,195496,869140,2129657,ITH,ITH2
2022-12-25T17:00:00,ITA,01,Piemonte,45.0732745,7.680687483,599,19,618,32102,32720,-290,698,1651003,13771,,,1697494,20877953,4339375,,2,,,516060,1181434,5092450,15785503,ITC,ITC1
2022-12-25T17:00:00,ITA,16,Puglia,41.12559576,16.86736689,272,10,282,13379,13661,-164,931,1566492,9397,,,1589550,13443253,2791829,,0,,,509013,1080537,4778006,8665247,ITF,ITF4
2022-12-25T17:00:00,ITA,20,Sardegna,39.21531192,9.110616306,117,7,124,6162,6286,95,220,487558,2864,,,496708,5336796,1754448,,1,,"L'incremento dei nuovi casi tiene conto anche dei casi diagnosticati con test antigenico. Pertanto si specifica che dei 220 casi dichiarati oggi, 219 sono stati diagnosticati da tampone antigenico ",178250,318458,2205201,3131595,ITG,ITG2
2022-12-25T17:00:00,ITA,19,Sicilia,38.11569725,13.3623567,473,35,508,30981,31489,-1458,1059,1727174,12424,,,1771087,16040422,10404917,,1,,,531705,1239382,5205958,10834464,ITG,ITG1
2022-12-25T17:00:00,ITA,09,Toscana,43.76923077,11.25588885,458,16,474,72784,73258,104,928,1478186,11323,,,1562767,16381770,5352484,,3,,,707607,855160,7044321,9337449,ITI,ITI1
2022-12-25T17:00:00,ITA,10,Umbria,43.10675841,12.38824698,247,8,255,2962,3217,-1,378,420722,2328,,,426267,4939596,804070,"- Si fa presente che 109 dei ricoveri non UTI appartengono ad altri codici disciplina di cui 53 in discipline post-acuto, riabilitative ( cod. 60, 28, 56, 75 )",1,,,157502,268765,1741880,3197716,ITI,ITI2
2022-12-25T17:00:00,ITA,02,Valle d'Aosta,45.73750286,7.320149366,16,0,16,784,800,99,131,48594,563,,,49957,581077,144341,Si precisa che l'incremento dei casi confermati giornalieri comprende anche l'incremento della giornata di ieri 24/12/2022,0,,,16223,33734,145191,435886,ITC,ITC2
2022-12-25T17:00:00,ITA,05,Veneto,45.43490485,12.33845213,850,38,888,48870,49758,-1291,1913,2564797,16253,,,2630808,35980731,5243605,Nei valori riportati per le terapie intensive si è verificato un disallineamento temporale del flusso informativo pertanto per convenzione è stato riportato  3 dimessi da TI  invece del n. 2 effettivi che include anche i negativizzati.,6,,,1035405,1595403,11160049,24820682,ITH,ITH3
