data,stato,codice_regione,denominazione_regione,lat,long,ricoverati_con_sintomi,terapia_intensiva,totale_ospedalizzati,isolamento_domiciliare,totale_positivi,variazione_totale_positivi,nuovi_positivi,dimessi_guariti,deceduti,casi_da_sospetto_diagnostico,casi_da_screening,totale_casi,tamponi,casi_testati,note,ingressi_terapia_intensiva,note_test,note_casi,totale_positivi_test_molecolare,totale_positivi_test_antigenico_rapido,tamponi_test_molecolare,tamponi_test_antigenico_rapido,codice_nuts_1,codice_nuts_2
2024-06-22T17:00:00,ITA,13,Abruzzo,42.35122196,13.39843823,2,0,2,880,882,4,4,684223,4094,,,689199,7715814,1394853,"Il dato incremento casi confermati è composto da 4, cioè 1 ''nuovo positivo'' e 3 ''reinfezioni.",0,,,264215,424984,2651373,5064441,ITF,ITF1
2024-06-22T17:00:00,ITA,17,Basilicata,40.63947052,15.80514834,0,0,0,9881,9881,-1,0,191620,1055,,,202556,1379875,411712,Il dato relativo al numero dei “Casi in isolamento domiciliare” ed ai “Guariti” non è reale ed è in corso di revisione.,0,,,71288,131268,704040,675835,ITF,ITF5
2024-06-22T17:00:00,ITA,18,Calabria,38.90597598,16.59440194,3,1,4,3457,3461,4,9,648240,3681,,,655382,4561279,3574767,,0,,,204378,451004,1966838,2594441,ITF,ITF6
2024-06-22T17:00:00,ITA,15,Campania,40.83956555,14.25084984,70,3,73,4443,4516,1,35,2532836,12146,,,2549498,22083252,5553078,,0,,,960016,1589482,9770610,12312642,ITF,ITF3
2024-06-22T17:00:00,ITA,08,Emilia-Romagna,44.49436681,11.3417208,75,1,76,617,693,20,20,2190449,20043,,,2211185,20169194,3006636,"Il dato odierno dei casi per la provincia, risultato negativo rispetto a quello comunicato ieri, è determinato dalla revisione delle posizioni anagrafiche dei casi precedentemente inseriti.",0,,,1100233,1110952,10836541,9332653,ITH,ITH5
2024-06-22T17:00:00,ITA,06,Friuli Venezia Giulia,45.6494354,13.76813649,11,0,11,314,325,10,13,592117,6463,,,598905,7902013,1282376,Il totale dei casi positivi è stato ridotto di 1 a seguito di un test positivo rimosso dopo revisione del caso (caso relativo alla provincia di TS).		,0,,,242554,356351,3901271,4000742,ITH,ITH4
2024-06-22T17:00:00,ITA,12,Lazio,41.89277044,12.48366722,79,2,81,62085,62166,42,65,2458167,13274,,,2533607,27703327,6297045,,0,,,1043134,1490473,9765816,17937511,ITI,ITI4
2024-06-22T17:00:00,ITA,07,Liguria,44.41149315,8.9326992,16,3,19,0,19,3,10,684461,6019,,,690499,7169555,1554165,"Si segnala che in seguito all’automatizzazione nella gestione dei database relativi alla sorveglianza COVID-19, sono possibili variazioni delle anagrafiche che possono generare eventuali riduzioni rispetto ai dati comunicati nelle giornate precedenti.",0,,*di cui 61181  reinfezioni a partire dal 3/09/2021 [circ. min sal. n.37911 del 20/08/2021].,288522,401977,2715914,4453641,ITC,ITC3
2024-06-22T17:00:00,ITA,03,Lombardia,45.46679409,9.190347404,54,4,58,737,795,40,71,4293938,47952,,,4342685,47397501,9496520,,1,,,1553671,2789014,17225022,30172479,ITC,ITC4
2024-06-22T17:00:00,ITA,11,Marche,43.61675973,13.5188753,4,0,4,0,4,0,1,732503,4560,,,737067,3807721,2805363,,0,,,223418,513649,2020964,1786757,ITI,ITI3
2024-06-22T17:00:00,ITA,14,Molise,41.55774754,14.65916051,1,0,1,5,6,0,0,104779,798,,,105583,856772,807486,,0,,,31124,74459,556296,300476,ITF,ITF2
2024-06-22T17:00:00,ITA,21,P.A. Bolzano,46.49933453,11.35662422,0,0,0,0,0,0,1,299389,1671,,,301060,5629847,871262,"1 nuovi positivi di cui 0 test antigenici confermati da test molecolare, 0 casi diagnosticati con test antigenico e 1 nuovi positivi al test PCR.",0,,"1 nuovi positivi di cui 0 test antigenici confermati da test molecolare, 0 casi diagnosticati con test antigenico e 1 nuovi positivi al test PCR.",87671,213389,945607,4684240,ITH,ITH1
2024-06-22T17:00:00,ITA,22,P.A. Trento,46.06893511,11.12123097,6,1,7,18,25,1,1,251847,1681,,,253553,3097486,610635,,0,,,45819,207734,880252,2217234,ITH,ITH2
2024-06-22T17:00:00,ITA,01,Piemonte,45.0732745,7.680687483,70,1,71,53136,53207,-22,66,1737887,13929,,,1805023,22686740,4551550,,0,,,519940,1285083,5153768,17532972,ITC,ITC1
2024-06-22T17:00:00,ITA,16,Puglia,41.12559576,16.86736689,7,0,7,254,261,11,14,1678613,10088,,,1688962,14720842,3051650,,0,,,515278,1173684,4893744,9827098,ITF,ITF4
2024-06-22T17:00:00,ITA,20,Sardegna,39.21531192,9.110616306,23,1,24,9621,9645,21,22,514029,2978,,,526652,5600503,1767764,,0,,,180340,346312,2247824,3352679,ITG,ITG2
2024-06-22T17:00:00,ITA,19,Sicilia,38.11569725,13.3623567,64,1,65,961,1026,4,4,1820905,13063,,,1834994,16973823,11309860,,0,,,543246,1291748,5505311,11468512,ITG,ITG1
2024-06-22T17:00:00,ITA,09,Toscana,43.76923077,11.25588885,73,3,76,387,463,58,0,1641696,12513,,,1654672,17416230,5481451,,0,,,732909,921763,7155639,10260591,ITI,ITI1
2024-06-22T17:00:00,ITA,10,Umbria,43.10675841,12.38824698,9,0,9,541,550,1,2,456101,2532,,,459183,5185036,831007,"Si fa presente che dei 9 ricoveri non in T.I.: - 2 appartengono alle discipline di area medica (COD.24, COD.26, COD.68, COD.94) - 7 ricoveri appartengono ad altre discipline ospedaliere.",0,,,160703,298480,1765203,3419833,ITI,ITI2
2024-06-22T17:00:00,ITA,02,Valle d'Aosta,45.73750286,7.320149366,3,0,3,9,12,0,0,51891,591,,,52494,609429,149128,,0,,,16498,35996,146784,462645,ITC,ITC2
2024-06-22T17:00:00,ITA,05,Veneto,45.43490485,12.33845213,178,9,187,9760,9947,27,43,2815202,17493,,,2842642,39499951,5460875,Si segnala che è presente un delta negativo registrato per i casi positivi nella provincia di Verona e altro. Dall'analisi effettuata emerge che il delta negativo registrato è un risultato fisiologico dell’elaborazione che registra pochi casi nuovi di positività e che può essere indotto in particolare da un cambio domicilio/residenza o variazioni inviate sugli episodi precedenti.,0,,,1151059,1691583,12246347,27253604,ITH,ITH3
