data,stato,codice_regione,denominazione_regione,lat,long,ricoverati_con_sintomi,terapia_intensiva,totale_ospedalizzati,isolamento_domiciliare,totale_positivi,variazione_totale_positivi,nuovi_positivi,dimessi_guariti,deceduti,casi_da_sospetto_diagnostico,casi_da_screening,totale_casi,tamponi,casi_testati,note,ingressi_terapia_intensiva,note_test,note_casi,totale_positivi_test_molecolare,totale_positivi_test_antigenico_rapido,tamponi_test_molecolare,tamponi_test_antigenico_rapido,codice_nuts_1,codice_nuts_2
2023-01-11T17:00:00,ITA,13,Abruzzo,42.35122196,13.39843823,206,5,211,13974,14185,-385,391,624516,3856,,,642557,7315042,1357241,"Del totale dei decessi comunicati in data odierna, 2 casi sono avvenuti nei giorni scorsi e comunicati oggi dalla Asl Avezzano - Sulmona - L'Aquila",1,,,242945,399612,2565111,4749931,ITF,ITF1
2023-01-11T17:00:00,ITA,17,Basilicata,40.63947052,15.80514834,50,1,51,8609,8660,32,93,188595,1012,,,198267,1309720,399005,Il dato relativo al numero dei “Casi in isolamento domiciliare” ed ai “Guariti” è in corso di revisione.,1,,,71014,127253,698475,611245,ITF,ITF5
2023-01-11T17:00:00,ITA,18,Calabria,38.90597598,16.59440194,176,11,187,4236,4423,-345,532,616068,3254,,,623745,4143194,3198450,,0,,,200692,423053,1863368,2279826,ITF,ITF6
2023-01-11T17:00:00,ITA,15,Campania,40.83956555,14.25084984,362,22,384,41522,41906,-469,1182,2371854,11618,,,2425378,20148473,5344448,,3,,,951704,1473674,9436373,10712100,ITF,ITF3
2023-01-11T17:00:00,ITA,08,Emilia-Romagna,44.49436681,11.3417208,1159,45,1204,15906,17110,-7,955,2082917,19076,,,2119103,19061964,2951222,,3,,,1086256,1032847,10532724,8529240,ITH,ITH5
2023-01-11T17:00:00,ITA,06,Friuli Venezia Giulia,45.6494354,13.76813649,190,3,193,3959,4152,-481,282,559657,5893,,,569702,7586428,1245402,"Dei 3 decessi oggi riportati, 2 sono avvenuti nei mesi precedenti.",1,,,237709,331993,3781706,3804722,ITH,ITH4
2023-01-11T17:00:00,ITA,12,Lazio,41.89277044,12.48366722,737,30,767,38436,39203,-1633,1323,2294995,12607,,,2346805,25693372,6058363,,1,,,1032826,1313979,9553261,16140111,ITI,ITI4
2023-01-11T17:00:00,ITA,07,Liguria,44.41149315,8.9326992,285,7,292,3480,3772,-156,185,647145,5825,,,656742,6772662,1496706,,0,,*di cui 48846  reinfezioni a partire dal 3/09/2021 [circ. min sal. n.37911 del 20/08/2021]. ,282029,374713,2672053,4100609,ITC,ITC3
2023-01-11T17:00:00,ITA,03,Lombardia,45.46679409,9.190347404,738,28,766,16215,16981,-2234,1388,4021889,45006,,,4083876,44500161,9109498,,1,,,1531917,2551959,16936684,27563477,ITC,ITC4
2023-01-11T17:00:00,ITA,11,Marche,43.61675973,13.5188753,139,5,144,5481,5625,-15,268,698864,4328,,,708817,3705686,2703392,,0,,,222607,486210,2015439,1690247,ITI,ITI3
2023-01-11T17:00:00,ITA,14,Molise,41.55774754,14.65916051,15,2,17,6344,6361,-869,92,93877,709,,,100947,783797,736585,,1,,,29215,71732,510847,272950,ITF,ITF2
2023-01-11T17:00:00,ITA,21,P.A. Bolzano,46.49933453,11.35662422,28,3,31,521,552,-115,78,288727,1606,,,290885,5540384,861398,"78 nuovi positivi di cui 1 test antigenici confermati da test molecolare, 71 casi diagnosticati con test antigenico e 6 nuovi positivi al test PCR. ",0,,"78 nuovi positivi di cui 1 test antigenici confermati da test molecolare, 71 casi diagnosticati con test antigenico e 6 nuovi positivi al test PCR. ",86918,203967,929237,4611147,ITH,ITH1
2023-01-11T17:00:00,ITA,22,P.A. Trento,46.06893511,11.12123097,46,3,49,889,938,-51,92,239412,1636,,,241986,3013020,602360,,0,,,44714,197272,870849,2142171,ITH,ITH2
2023-01-11T17:00:00,ITA,01,Piemonte,45.0732745,7.680687483,428,10,438,26398,26836,-351,333,1668428,13809,,,1709073,21026074,4353215,,2,,,516635,1192438,5098998,15927076,ITC,ITC1
2023-01-11T17:00:00,ITA,16,Puglia,41.12559576,16.86736689,231,15,246,18222,18468,-151,997,1583756,9480,,,1611704,13566605,2811866,,3,,,510383,1101321,4793764,8772841,ITF,ITF4
2023-01-11T17:00:00,ITA,20,Sardegna,39.21531192,9.110616306,102,9,111,5452,5563,-480,322,495257,2877,,,503697,5366757,1756659,,0,,"L'incremento dei nuovi casi tiene conto anche dei casi diagnosticati con test antigenico. Pertanto si specifica che dei 322 casi dichiarati oggi, 297 sono stati diagnosticati da tampone antigenico Si segnala il decesso dei paz.:  - 1 donna 85 aa Residente nella Città Metropolitana di Cagliari",178897,324800,2211940,3154817,ITG,ITG2
2023-01-11T17:00:00,ITA,19,Sicilia,38.11569725,13.3623567,569,50,619,38484,39103,-916,1250,1745701,12506,,,1797310,16191412,10552421,,6,,,533822,1263488,5236551,10954861,ITG,ITG1
2023-01-11T17:00:00,ITA,09,Toscana,43.76923077,11.25588885,368,22,390,72109,72499,-308,674,1492552,11425,,,1576476,16466084,5368568,,5,,,710283,866193,7052936,9413148,ITI,ITI1
2023-01-11T17:00:00,ITA,10,Umbria,43.10675841,12.38824698,210,9,219,3339,3558,21,282,426571,2369,,,432498,4970478,807162,"- Si fa presente che 3 dei ricoveri non UTI appartengono ai codici disciplina di Ostetricia & Ginecologia e Pediatria. - Si fa presente che 87 dei ricoveri non UTI appartengono ad altri codici disciplina di cui 18 in discipline post-acuto, riabilitative ( cod. 60, 28, 56, 75 )",1,,,158215,274283,1746971,3223507,ITI,ITI2
2023-01-11T17:00:00,ITA,02,Valle d'Aosta,45.73750286,7.320149366,1,0,1,813,814,4,14,48832,565,,,50211,583583,144879,,0,,,16231,33980,145308,438275,ITC,ITC2
2023-01-11T17:00:00,ITA,05,Veneto,45.43490485,12.33845213,682,37,719,29920,30639,-2510,1387,2616074,16432,,,2663145,36310962,5259473,Nei valori riportati per le terapie intensive si è verificato un disallineamento temporale del flusso informativo pertanto per convenzione è stato riportato 1 dimessi da TI  invece del n. 3 effettivi che include anche i negativizzati.,8,,,1047166,1615979,11228676,25082286,ITH,ITH3
